########################################################################################################################################################################################################
########################################################################################################################################################################################################
########################################################################################################################################################################################################
########################################################################################################################################################################################################
########################################################################################################################################################################################################
########################################################################################################################################################################################################
########################################################################################################################################################################################################
########################################################################################################################################################################################################
########################################################################################################################################################################################################
########################################################################################################################################################################################################
########################################################################################################################################################################################################
########################################################################################################################################################################################################
########################################################################################################################################################################################################
########################################################################################################################################################################################################
########################################################################################################################################################################################################
########################################################################################################################################################################################################
########################################################################################################################################################################################################
########################################################################################################################################################################################################
########################################################################################################################################################################################################
########################################################################################################################################################################################################
#################################......#################################################################################################################################################################
#################################.......################################################################################################################################################################
#################################...................########################################################....................................########################################################
#################################...............##..########################################################.............................#@#.....#######################################################
#################################..............#@@#.########################################################.............................#@#.....#######################################################
#################################...................########################################################.....................................#######################################################
#############################################.......########################################################.......##############..............#########################################################
#############################################.......########################################################.......#####################.......#########################################################
#############################################.......#######################################################........#####################.......#########################################################
#############################################.......#######################################################........#####################.......#########################################################
#############################################.......#######################################################........#####################.......#########################################################
#############################################.......#######################################################........#####################.......#########################################################
#############################################.......#######################################################........#####################.......#########################################################
#############################################.......#######################################################........#####################.......#########################################################
#############################################.......#######################################################........#####################.......#########################################################
#############################################.......#######################################################........#####################.......#########################################################
#############################################.......##################################################.............#####################.......#########################################################
#############################################.......#####################################..........................#####################.......#########################################################
############################........................####################################...........................#####################.......#########################################################
###########################.........................#####...############################..........................######################.......#########################################################
###########################.........................###.......##########################.........................#######################.......#########################################################
###########################.........................###..#@@#.#########################........#########################################.......#########################################################
###########################.........................###...#...#########################........#########################################.......#########################################################
###########################.......###########.......##......................###########........#########################################.......#########################################################
###########################...#@#.###########............................................................###..............##############.......#########################################################
###########################....#..###########............................................................#@#...............#############.......#########################################################
###########################.......###########..............................................................................#############.......#########################################################
###########################.......############.............................................................................#############.......#########################################################
##########################........####################........###############.......################################.......#############.......#########################........................########
##########################........####################........###############.......################################.......#############....................................................#....#######
##########################........####################...#@#..###############.......################################........############...................................................#@#....######
############################.....#####################....##..###############.......#####...................................###########............#@#...........................................#######
#######################################################......################.......####..................##................###########............###.........................................#########
#############################################################################.......####.................#@@...............############........#########################################################
#############################################################################.......#####.................................#############........#########################################################
#############################################################################.......###################################################........#########################################################
#############################################################################.......###################################################..................###############################################
#############################################################################.......###################################################.........#@##.....###############################################
#############################################################################.......###################################################..........##......###############################################
#############################################################################.......###################################################..................###############################################
############################################################################........###################################################........#########################################################
############################################################################........###################################################........#########################################################
############################################################################........###################################################........#########################################################
############################################################################........###################################################........#########################################################
############################################################################........###################################################........#########################################################
##############################################################.........#####........###################################################........#########################################################
############################################################........................###################################################........#########################################################
###########################################################...#@#.......................................###############################........#########################################################
############################################################........................................@@#..##############################........#########################################################
#############################################################.......................................##...##############################........#########################################################
############################################################################.............................##############################........#########################################################
############################################################################........###################################################...#@#..#########################################################
############################################################################........###################################################...###..#########################################################
############################################################################........###################################################.#......#########################################################
############################################################################........####################################################.......#########################################################
############################################################################........######################################################..############################################################
############################################################################...@@#..####################################################################################################################
############################################################################...##...####################################################################################################################
#############################################################################.......####################################################################################################################
##############################################################################.....#####################################################################################################################
########################################################################################################################################################################################################
########################################################################################################################################################################################################
########################################################################################################################################################################################################
########################################################################################################################################################################################################
########################################################################################################################################################################################################
########################################################################################################################################################################################################
########################################################################################################################################################################################################
########################################################################################################################################################################################################
########################################################################################################################################################################################################
########################################################################################################################################################################################################
########################################################################################################################################################################################################
########################################################################################################################################################################################################
########################################################################################################################################################################################################
########################################################################################################################################################################################################
########################################################################################################################################################################################################
########################################################################################################################################################################################################
########################################################################################################################################################################################################
########################################################################################################################################################################################################
########################################################################################################################################################################################################
########################################################################################################################################################################################################
